ástralska	au s t r a l s k a
ástralskan	au s t r a l s k a n
ástralskir	au s t r a l s c ɪ r
ástralskum	au s t r a l s k ʏ m
ástralskur	au s t r a l s k ʏ r
áströlskum	au s t r œ l s k ʏ m
átján	auː t j au n
átta	au h t a
áttatíu	au h t a t iː j ʏ
áttatíu	au h t a t i j ʏ
bandaríkjadali	p a n t a r i c a t aː l ɪ
bandaríkjadalir	p a n t a r i c a t aː l ɪ r
bandaríkjadal	p a n t a r i c a t aː l
bandaríkjadalur	p a n t a r i c a t aː l ʏ r
bandaríkjadölum	p a n t a r i c a t œː l ʏ m
bati	p aː t ɪ
bat	p aː t
bolla	p ɔ t l a
bollar	p ɔ t l a r
bolli	p ɔ t l ɪ
bollum	p ɔ t l ʏ m
böt	p œː t
bötum	p œː t ʏ m
brasilísk	p r aː s ɪ l i s k
brasilískt	p r aː s ɪ l i s t
brasilískum	p r aː s ɪ l i s k ʏ m
brasilísku	p r aː s ɪ l i s k ʏ
Breyttu	p r ei h t ʏ
búlgarísku	p u l k a r i s k ʏ
búlgarskt	p u l k a r s t
búlgörsk	p u l k œ r̥ s k
búlgörskum	p u l k œ r̥ s k ʏ m
dalir	t aː l ɪ r
dali	t aː l ɪ
dal	t aː l
dalur	t aː l ʏ r
danskar	t a n s k a r
danska	t a n s k a
desilítrar	t ɛː s ɪ l i t r a r
desilítra	t ɛː s ɪ l i t r a
desilítri	t ɛː s ɪ l i t r ɪ
desilítrum	t ɛː s ɪ l i t r ʏ m
dölum	t œː l ʏ m
dönsk	t œ n s k
dönskum	t œ n s k ʏ m
ég	j ɛː ɣ
eina	eiː n a
ein	eiː n
ein	ei n
einn	ei t n̥
einni	ei t n ɪ
einu	eiː n ʏ
einum	eiː n ʏ m
einum	ei n ʏ m
eitt	ei h t
ellefu	ɛ t l ɛ v ʏ
er	ɛː r
eru	ɛː r ʏ
evra	ɛ v r a
evru	ɛ v r ʏ
evrum	ɛ v r ʏ m
evrur	ɛ v r ʏ r
fæ	f aiː
fet	f ɛː t
feti	f ɛː t ɪ
fetum	f ɛː t ʏ m
fimm	f ɪ m
fimmtán	f ɪ m̥ t au n
fimmtíu	f ɪ m̥ t i j ʏ
fjögur	f j œː ɣ ʏ r
fjóra	f j ouː r a
fjórar	f j ouː r a r
fjórar	f j ou r a r
fjórir	f j ouː r ɪ r
fjórtán	f j ou r̥ t au n
fjórum	f j ouː r ʏ m
fjörutíu	f j œː r t i j ʏ
fjörutíu	f j œ r t i j ʏ
fórinta	f ouː r ɪ n̥ t a
fórintu	f ou r̥ ɪ n̥ t ʏ
fórintum	f ouː r ɪ n̥ t ʏ m
fórintur	f ouː r ɪ n̥ t ʏ r
franka	f r au ŋ̊ k a
frankar	f r au ŋ k a r
franki	f r au n̥ c ɪ
frönkum	f r œy ŋ̊ k ʏ m
fyrir	f ɪː r ɪ r
grammi	k r a m ɪ
gramm	k r a m
gramm	k r a m m
grömm	k r œ m
grömmum	k r œ m ʏ m
hálfa	h au l v a
hálfan	h au l v a n
hálf	h au l v
hálfri	h au l r ɪ
hálfri	h au l v r ɪ
hálfs	h au l s
hálft	h au l̥ t
hálfu	h au l v ʏ
hálfum	h au l v ʏ m
hálfur	h au l v ʏ r
hong	h ɔ ŋ k
hundrað	h ʏ n t r a ð
hundruð	h ʏ n t r ʏ ð
Hvað	k v aː ð
Hversu	k v ɛ r̥ s ʏ
í	iː
indverska	ɪ n t v ɛ r̥ s k a
indverskar	ɪ n t v ɛ r̥ s k a r
indversk	ɪ n t v ɛ r̥ s k
indverskum	ɪ n t v ɛ r̥ s k ʏ m
ísraelska	iː s r a ɛ l s k a
ísraelskan	iː s r a ɛ l s k a n
ísraelskir	iː s r a ɛ l s c ɪ r
ísraelskum	iː s r a ɛ l s k ʏ m
ísraelskur	iː s r a ɛ l s k ʏ r
ísrelskum	iː s r ɛ l s k ʏ m
jamaíska	j a m aː i s k a
jamaískan	j a m aː i s k a n
jamaískir	j a m aː i s c ɪ r
jamaískum	j a m aː i s k ʏ m
jamaískur	j a m aː i s k ʏ r
jamískum	j a m i s k ʏ m
janpönsku	j aː n p œ n s k ʏ
japanskt	j aː p a n s t
japönsk	j aː p œ n s k
japönskum	j aː p œ n s k ʏ m
jeni	j ɛː n ɪ
jen	j ɛː n
jenum	j ɛː n ʏ m
júani	j uː a n ɪ
júan	j uː a n
júön	j uː œː n
júönum	j uː œː n ʏ m
kanadadalir	kʰ aː n a t a t aː l ɪ r
kanadadal	kʰ aː n a t a t aː l
kanadadalur	kʰ aː n a t a t aː l ʏ r
kanadali	kʰ aː n a t aː l ɪ
kandadölum	kʰ a n t a t œː l ʏ m
kanna	kʰ a n a
kíló	cʰ iː l ou
kílógramm	cʰ iː l ou k r a m
kílógrammi	cʰ iː l ou k r a m ɪ
kílógrömm	cʰ iː l ou k r œ m
kílógrömmum	cʰ iː l ou k r œ m ʏ m
kílói	cʰ iː l ou ɪ
kílómetra	cʰ iː l ou m ɛː t r a
kílómetrar	cʰ iː l ou m ɛː t r a r
kílómetrar	cʰ iː l ou m ɛ t r a r
kílómetri	cʰ iː l ou m ɛː t r ɪ
kílómetrum	cʰ iː l ou m ɛː t r ʏ m
kílóum	cʰ iː l ou ʏ m
kínversk	cʰ i n v ɛ r̥ s k
kínverskt	cʰ i n v ɛ r̥ s t
kínversku	cʰ i n v ɛ r s k ʏ
kínversku	cʰ i n v ɛ r̥ s k ʏ
kínverskum	cʰ i n v ɛ r̥ s k ʏ m
komma	kʰ ɔ m a
kong	kʰ ɔ ŋ k
könnu	kʰ œ n ʏ
könnum	kʰ œ n ʏ m
könnur	kʰ œ n ʏ r
króatíska	kʰ r ouː a tʰ i s k a
króatíska	kʰ r ouː a t i s k a
króatískar	kʰ r ouː a t i s k a r
króatísk	kʰ r ouː a t i s k
króatískum	kʰ r ouː a t i s k ʏ m
króna	kʰ r ouː n a
króna	kʰ r ou n a
krónu	kʰ r ouː n ʏ
krónum	kʰ r ouː n ʏ m
krónur	kʰ r ouː n ʏ r
krónur	kʰ r ou n ʏ r
kúna	kʰ uː n a
kúnu	kʰ uː n ʏ
kúnum	kʰ uː n ʏ m
kúnur	kʰ uː n ʏ r
lefi	l ɛː v ɪ
lef	l ɛː v
lefum	l ɛː v ʏ m
líra	l iː r a
líru	l i r ʏ
lírum	l iː r ʏ m
lírur	l iː r ʏ r
lítra	l iː t r a
lítrar	l iː t r a r
lítri	l iː t r ɪ
lítrum	l iː t r ʏ m
marga	m a r k a
margar	m a r k a r
margir	m a r c ɪ r
matskeiðar	m aː t s c eiː ð a r
matskeið	m aː t s c eiː ð
matskeið	m aː t s c ei ð
matskeiðum	m aː t s c ei ð ʏ m
metra	m ɛː t r a
metrar	m ɛː t r a r
metri	m ɛː t r ɪ
metrum	m ɛː t r ʏ m
mexíkóska	m ɛ k s i k ou s k a
mexíkóskan	m ɛ k s i k ou s k a n
mexíkóskir	m ɛ k s i k ouː s c ɪ r
mexíkóskum	m ɛ k s i k ouː s k ʏ m
mexikóskum	m ɛ k s ɪ k ou s k ʏ m
mexíkóskur	m ɛ k s i k ouː s k ʏ r
míla	m iː l a
míla	m i l a
milligrammi	m ɪ t l ɪ k r a m ɪ
milligramm	m ɪ t l ɪ k r a m
milligrömm	m ɪ t l ɪ k r œ m
milligrömmum	m ɪ t l ɪ k r œ m ʏ m
millimetra	m ɪ l ɪ m ɛː t r a
millimetra	m ɪ t l ɪ m ɛː t r a
millimetrar	m ɪ l ɪ m ɛː t r a r
millimetrar	m ɪ t l ɪ m ɛː t r a r
millimetri	m ɪ l ɪ m ɛː t r ɪ
millimetrum	m ɪ l ɪ m ɛː t r ʏ m
millimetrum	m ɪ t l ɪ m ɛː t r ʏ m
mílu	m iː l ʏ
mílu	m i l ʏ
mílum	m iː l ʏ m
mílur	m iː l ʏ r
mörg	m œ r k
næra	n aiː r a
nærum	n ai r ʏ m
næru	n ai r ʏ
nærur	n ai r ʏ r
nígeríska	n iː k ɛ r i s k a
nígerískar	n iː k ɛ r i s k a r
nígerísk	n iː k ɛ r i s k
nígerískum	n iː k ɛ r i s k ʏ m
nítján	n iː t j au n
níu	n iː j ʏ
níutíu	n iː t i j ʏ
norska	n ɔ r̥ s k a
norskar	n ɔ r̥ s k a r
norsk	n ɔ r̥ s k
norskum	n ɔ r̥ s k ʏ m
núll	n u l
nýsjálenska	n iː s j au l ɛ n s k a
nýsjálenskan	n iː s j au l ɛ n s k a n
nýsjálenskir	n iː s j au l ɛ n s c ɪ r
nýsjálenskum	n iː s j au l ɛ n s k ʏ m
nýsjálenskur	n iː s j au l ɛ n s k ʏ r
og	ɔː ɣ
pela	pʰ ɛː l a
pelar	pʰ ɛː l a r
peli	pʰ ɛː l ɪ
pelum	pʰ ɛː l ʏ m
pesa	pʰ ɛː s a
pesar	pʰ ɛː s a r
pesi	pʰ ɛ s ɪ
pesum	pʰ ɛː s ʏ m
pinti	pʰ ɪ n̥ t ɪ
pint	pʰ ɪ n̥ t
pintum	pʰ ɪ n̥ t ʏ m
pólsk	pʰ ou l s k
pólskt	pʰ ouː l s t
pólskum	pʰ ou l s k ʏ m
pólsku	pʰ ou l s k ʏ
pundi	pʰ ʏ n t ɪ
pund	pʰ ʏ n t
pundum	pʰ ʏ n t ʏ m
randi	r a n t ɪ
rand	r a n t
ríali	r iː j a l ɪ
ríal	r iː j a l
ríöl	r iː œː l
ríölum	r iː œː l ʏ m
rönd	r œ n t
röndum	r œ n t ʏ m
rúmmetrar	r u m ɛ t r a r
rúmmetra	r u m ɛ t r a
rúmmetri	r u m ɛ t r ɪ
rúmmetrum	r u m ɛ t r ʏ m
rúmsentímetrar	r u m s ɛ n̥ t i m ɛː t r a r
rúmsentímetra	r u m s ɛ n̥ t i m ɛː t r a
rúmsentimetra	r u m s ɛ n̥ t ɪ m ɛː t r a
rúmsentímetri	r u m s ɛ n̥ t i m ɛː t r ɪ
rúmsentimetrum	r u m s ɛ n̥ t ɪ m ɛː t r ʏ m
rúpía	r uː p i j a
rúpíum	r uː p i j ʏ m
rúpíur	r uː p i j ʏ r
rúpíu	r uː p i j ʏ
sádiarabísk	s auː t ɪ aː r a p i s k
sádiarabískt	s auː t ɪ aː r a p i s t
sádiarabískum	s auː t ɪ aː r a p i s k ʏ m
sádiarabísku	s auː t ɪ aː r a p i s k ʏ
sænskar	s ai n s k a r
sænska	s ai n s k a
sænsk	s ai n s k
sænskum	s ai n s k ʏ m
sautján	s œyː t j au n
sentilítrar	s ɛ n̥ t ɪ l iː t r a r
sentilítra	s ɛ n̥ t ɪ l iː t r a
sentilítri	s ɛ n̥ t ɪ l iː t r ɪ
sentilítrum	s ɛ n̥ t ɪ l iː t r ʏ m
sentimetrar	s ɛ n̥ t ɪ m ɛː t r a r
sentimetra	s ɛ n̥ t ɪ m ɛː t r a
sentimetri	s ɛ n̥ t ɪ m ɛː t r ɪ
sentimetrum	s ɛ n̥ t ɪ m ɛː t r ʏ m
sex	s ɛ k s
sextán	s ɛ k s t au n
sextíu	s ɛ k s t i j ʏ
sikill	s ɪː c ɪ t l̥
sikil	s ɪː c ɪ l
siklar	s ɪ h k l a r
sikla	s ɪ h k l a
sikli	s ɪ h k l ɪ
siklum	s ɪ h k l ʏ m
singapúrskan	s i ŋ k a p u r̥ s k a n
singapúrska	s i ŋ k a p u r̥ s k a
singapúrskir	s i ŋ k a p u r̥ s c ɪ r
singapúrskum	s i ŋ k a p u r̥ s k ʏ m
singapúrskur	s i ŋ k a p u r̥ s k ʏ r
sjómíla	s j ouː m i l a
sjómílum	s j ouː m i l ʏ m
sjómílur	s j ouː m i l ʏ r
sjómílu	s j ouː m i l ʏ
sjö	s j œː
sjötíu	s j œː t i j ʏ
slot	s t l ɔː t
slotti	s t l ɔ h t ɪ
slotum	s t l ɔː t ʏ m
sterlingspundi	s t ɛ r l i ŋ k s pʰ ʏ n t ɪ
sterlingspund	s t ɛ r l i ŋ k s pʰ ʏ n t
sterlingspundum	s t ɛ r l i ŋ k s pʰ ʏ n t ʏ m
suðurafrísk	s ʏː ð ʏ r̥ aː f r i s k
suðurafrískt	s ʏː ð ʏ r̥ aː f r i s t
suðurafrískum	s ʏː ð ʏ r̥ aː f r i s k ʏ m
suðurafrísku	s ʏː ð ʏ r̥ aː f r i s k ʏ
suðurkóresk	s ʏː ð ʏ r k ouː r ɛ s k
suðurkóreskt	s ʏː ð ʏ r k ouː r ɛ s t
suðurkóreskum	s ʏː ð ʏ r k ouː r ɛ s k ʏ m
suðurkóresku	s ʏː ð ʏ r k ouː r ɛ s k ʏ
súrínamskan	s uː r iː n a m s k a n
súrínamska	s uː r iː n a m s k a
súrínamskir	s uː r iː n a m s c ɪ r
súrínamskur	s uː r iː n a m s k ʏ r
súrínömskum	s uː r i n œ m s k ʏ m
svissneskan	s v ɪ s n ɛ s k a n
svissneska	s v ɪ s n ɛ s k a
svissneskir	s v ɪ s n ɛ s c ɪ r
svissneskum	s v ɪ s n ɛ s k ʏ m
svissneskur	s v ɪ s n ɛ s k ʏ r
taílensk	tʰ a i l ɛ n s k
taílenskt	tʰ a i l ɛ n s t
taílenskum	tʰ a i l ɛ n s k ʏ m
taílensku	tʰ aiː l ɛ n s k ʏ
tékkneskar	tʰ j ɛ h k n ɛ s k a r
tékkneska	tʰ j ɛ h k n ɛ s k a
tékknesk	tʰ j ɛ h k n ɛ s k
tékkneskum	tʰ j ɛ h k n ɛ s k ʏ m
teskeiðar	tʰ ɛː s c ei ð a r
teskeið	tʰ ɛː s c ei ð
teskeiðum	tʰ ɛː s c ei ð ʏ m
tíu	tʰ iː j ʏ
tólf	tʰ ou l v
tomma	tʰ ɔ m a
tommum	tʰ ɔ m ʏ m
tommur	tʰ ɔ m ʏ r
tommu	tʰ ɔ m ʏ
tonni	tʰ ɔ n ɪ
tonn	tʰ ɔ n
tonnum	tʰ ɔ n ʏ m
tuttugu	tʰ ʏ h t ʏ ɣ ʏ
tvær	tʰ v aiː r
tvær	t v aiː r
tveim	tʰ v eiː m
tveim	tʰ v ɛː m
tveim	t v eiː m
tveimur	tʰ v eiː m ʏ r
tveimur	tʰ v ɛː m ʏ r
tveimur	t v eiː m ʏ r
tveir	tʰ v eiː r
tveir	t v eiː r
tvö	tʰ v œː
tvo	tʰ v ou
tvo	tʰ v ɔː
tvö	t v œː
tyrkneskar	tʰ ɪ r̥ k n ɛ s k a r
tyrkneska	tʰ ɪ r̥ k n ɛ s k a
tyrknesk	tʰ ɪ r̥ k n ɛ s k
tyrkneskum	tʰ ɪ r̥ k n ɛ s k ʏ m
ungverskar	u ŋ k v ɛ r̥ s k a r
ungverska	u ŋ k v ɛ r̥ s k a
ungverskum	u ŋ k v ɛ r̥ s k ʏ m
ungversk	u ŋ k v ɛ r̥ s k
únsa	u n s a
únsum	u n s ʏ m
únsur	u n s ʏ r
únsu	u n s ʏ
vonni	v ɔ n ɪ
vonnum	v ɔ n ʏ m
vonn	v ɔ n
þremur	θ r ɛː m ʏ r
þrem	θ r ɛː m
þrettán	θ r ɛ h t au n
þrír	θ r iː r
þrjár	θ r j auː r
þrjátíu	θ r j auː t i j ʏ
þrjá	θ r j auː
þrjú	θ r j uː
þúsund	θ uː s ʏ n t
<unk> oov
